0000000000000000003000000000
0000000000000000003000000000
2222222300000000003000000000
0000000344444444443000000000
0000000300002230002222222322
0000000300002230000000000300
0000000300002230000000000300
2232221100002222222232222222
0030000000000000000030000000
0030000000000000000030000000
2222222223222222222230000000
0000000003000000000030000000
0000000003000000000030000000
0000000003000000000032222223
2222222222222222222222222223
1111111111111111111111111111