0000000000000000000000000003
3221223000000000000000000003
3000003000032222222223000003
3000003000030000000003111103
3121213000030000000003000000
3000003444434444440003000000
3000003000030000031112222223
3000003000030000030000000003
3000003000032222230000000003
2111311211230000000003111311
2111300000030000000003000300
2000300000030004444443000300
2222222232222222000003001111
0000000030000000000003000000
2222222222222222222222222222
1111111111111111111111111111